1111111111
1PEC100001
1111111111