11111
1E111
10001
11101
1C001
10111
101C1
10101
1P001
11111
