1111111111111111111111111111
10P00000000111000000000C0001
1100011000000000000000000001
111C001100000000C00000000111
1110001100000000001110000001
1100011000000000001110000001
110E011000000000000000000001

1111100000000C00000000000001
1111111111111111111111111111